+---------------------------------+
|   |                    +     |  |
|   |  +---------+             |  |
|   |  |         +---------+   |  |
|   |  |    +----+             |  |
|   |  |    |    |             |  |
|   |  +-+  |    +-------+     |  |
|   |   X|  |    |             |  |
|   +----+  +    +---------+   |  |
|              +           +   +  |
|              |                  |
+---------------------------------+